11,10,10,10,10,12,0,0,0,0,0,0,0,0,0,0,0,0,0,0,0,0,0,0,0,0,0,0,0,0,0,0,0,0,0,0,0,0,0,0,0,0,50,0,0,0,0,0,0,0,0,0,0,0,0,0,0,0,0,0,0,0,0,0,0,0,0,0,0,0,11,10,10,10,10,10,10,12
19,19,19,19,19,13,0,0,0,0,0,0,0,0,0,0,0,0,0,0,0,0,0,0,0,0,0,0,0,0,0,0,0,0,0,0,0,0,0,0,0,11,10,12,0,0,0,0,0,0,0,0,0,0,0,0,0,0,0,0,0,0,0,0,0,0,0,0,0,0,13,19,19,19,19,19,19,19
19,19,19,19,19,13,0,0,0,0,0,0,0,0,0,0,0,0,0,0,0,0,0,0,0,0,0,0,0,0,0,0,0,0,0,0,0,0,0,0,0,13,19,13,0,0,0,0,0,0,0,0,0,0,0,0,0,0,0,0,0,0,0,0,0,0,0,0,0,0,13,19,19,19,19,19,19,19
19,19,19,19,19,13,0,0,0,0,0,0,0,0,0,0,0,0,0,0,0,0,0,0,0,0,0,0,0,0,0,0,0,0,0,0,0,0,0,0,0,13,19,13,0,0,0,0,0,0,0,0,0,0,0,0,0,0,0,0,0,0,0,0,0,0,0,0,0,0,13,19,19,19,19,19,19,19
19,19,19,19,19,13,0,0,0,0,0,0,0,0,0,0,0,0,0,0,0,0,0,0,0,0,0,0,0,0,0,0,0,0,0,0,0,0,0,0,0,13,19,13,0,0,0,0,0,0,0,0,0,0,0,0,0,0,0,0,0,0,0,0,0,0,0,0,0,0,13,19,19,19,19,19,19,19
19,19,19,19,19,13,0,0,0,0,0,0,0,0,0,0,0,0,0,0,0,0,0,0,0,0,0,0,0,0,0,0,0,0,0,0,0,0,0,0,13,13,13,13,0,0,0,0,0,0,0,0,0,0,0,0,0,0,0,0,0,0,0,0,0,0,0,0,0,0,13,19,19,19,19,19,19,19
19,19,19,19,19,13,0,0,0,0,0,0,0,0,0,0,0,0,0,0,0,0,0,0,0,0,0,0,0,0,0,0,0,0,0,0,0,0,0,0,13,19,0,0,0,0,0,0,0,0,0,0,0,50,50,50,0,0,0,0,0,0,0,0,0,0,0,0,0,0,13,19,19,19,19,19,19,19
19,19,19,19,19,13,0,0,0,0,0,0,0,0,0,0,0,0,0,0,0,0,0,0,0,0,0,0,0,0,0,0,0,0,0,0,0,0,0,0,13,19,51,0,0,0,0,0,0,0,0,0,0,0,0,0,0,0,0,0,0,0,0,0,0,0,0,0,0,0,13,19,19,19,19,19,19,19
19,19,19,19,19,13,0,0,0,0,0,0,0,0,0,0,0,0,0,0,0,0,0,0,0,0,0,0,0,0,0,0,0,0,0,0,0,0,0,0,13,19,10,12,0,0,0,21,0,0,0,11,10,10,10,10,10,10,0,0,0,0,0,0,0,0,0,0,0,0,13,19,19,19,19,19,19,19
19,19,19,19,19,13,0,0,0,0,0,0,0,0,0,0,0,0,0,0,0,0,0,0,0,0,0,0,0,0,0,0,0,0,0,0,0,0,0,0,13,19,13,13,0,0,0,0,0,0,0,0,0,0,0,0,0,0,0,0,0,0,0,0,0,0,0,0,0,0,13,19,19,19,19,19,19,19
19,19,19,19,19,13,0,0,0,0,0,0,0,0,0,0,0,0,0,0,0,0,0,0,0,0,0,0,0,0,0,0,0,0,0,0,0,0,0,0,13,50,13,13,0,0,0,0,0,0,0,0,0,0,0,0,0,0,0,0,0,20,0,0,0,0,50,0,92,0,13,19,19,19,19,19,19,19
19,19,19,19,19,13,0,0,0,0,0,0,0,0,0,0,0,0,0,0,0,0,0,0,0,0,0,0,0,0,0,0,0,0,0,0,0,0,0,0,13,19,13,13,0,0,0,0,0,0,0,0,0,0,0,0,0,0,0,0,0,0,0,0,11,10,10,10,10,12,13,19,19,19,19,19,19,19
19,19,19,19,19,13,0,0,0,0,0,0,0,0,0,0,0,0,0,0,0,0,0,0,0,0,0,0,0,0,0,0,0,0,0,0,0,0,0,0,13,19,13,13,0,0,0,0,0,0,0,0,0,0,0,0,0,0,0,0,0,0,0,0,13,19,19,19,19,19,19,19,19,19,19,19,19,19
19,19,19,19,19,13,0,0,0,0,0,0,0,0,0,0,0,0,0,0,0,0,0,0,0,0,0,0,0,0,0,0,0,0,0,0,0,0,0,0,13,19,13,13,0,0,0,0,0,0,0,0,0,50,0,0,0,0,0,0,0,0,0,0,13,19,19,19,19,19,19,19,19,19,19,19,19,19
19,19,19,19,19,13,0,0,0,0,0,0,0,0,0,0,0,0,0,0,0,0,0,0,0,0,0,0,0,0,0,0,0,0,0,0,0,0,0,0,13,19,13,13,0,0,0,0,0,0,0,0,0,50,0,0,0,0,0,0,0,0,0,0,13,19,19,19,19,19,19,19,19,19,19,19,19,19
19,19,19,19,19,13,0,0,0,0,0,0,0,0,0,0,0,0,0,0,0,0,0,0,0,0,0,0,0,0,0,0,0,0,0,0,0,0,0,0,13,19,13,13,0,0,0,0,0,0,0,50,0,0,0,0,0,0,0,0,20,0,0,0,13,19,19,19,19,19,19,19,19,19,19,19,19,19
19,19,19,19,19,13,0,0,0,0,0,0,0,0,0,0,0,0,0,0,0,0,0,0,0,0,0,0,0,0,0,0,0,0,0,0,0,0,0,0,13,19,13,13,0,0,0,0,0,0,0,50,0,0,0,0,0,0,0,0,0,0,0,0,13,19,19,19,19,19,19,19,19,19,19,19,19,19
19,19,19,19,19,13,0,0,0,0,0,0,0,0,0,0,0,0,0,0,0,0,0,0,0,0,0,0,0,0,0,0,0,0,0,0,0,0,0,0,13,19,13,13,0,0,0,0,0,50,0,0,0,0,0,0,0,0,0,0,0,0,0,0,13,19,19,19,19,19,19,19,19,19,19,19,19,19
19,19,19,19,19,13,0,0,0,0,0,0,0,0,0,0,0,0,0,0,0,0,0,0,0,0,0,0,0,0,0,0,0,0,0,0,0,0,0,0,13,19,13,13,0,0,20,0,0,50,0,0,0,0,0,0,0,0,0,0,0,13,13,13,13,19,19,19,19,19,19,19,19,19,19,19,19,19
19,19,19,19,19,13,0,0,0,0,0,0,0,0,0,0,0,0,0,0,0,0,0,0,0,0,0,0,0,0,0,0,0,0,0,0,0,0,0,0,13,19,13,13,0,0,0,0,0,0,0,0,0,0,0,0,0,0,0,0,0,0,13,13,19,19,19,19,19,19,19,19,19,19,19,19,19,19
19,19,19,19,19,13,0,0,0,0,0,0,0,0,0,0,0,0,0,0,0,0,0,0,0,0,0,0,0,0,0,0,0,0,0,0,0,0,0,0,13,19,13,13,0,0,0,0,20,0,0,0,0,0,0,0,0,0,0,0,0,0,0,13,13,19,19,19,19,19,19,19,19,19,19,19,19,19
19,19,19,19,19,13,0,0,0,0,0,0,0,0,0,0,0,0,0,0,0,0,0,0,0,0,0,0,0,0,0,0,0,0,0,0,0,0,0,0,13,19,13,13,0,0,0,0,0,0,0,0,0,0,0,0,0,0,0,0,0,0,0,0,13,19,19,19,19,19,19,19,19,19,19,19,19,19
19,19,19,19,19,13,0,0,0,0,0,0,0,0,0,0,0,0,0,0,0,0,0,0,0,0,0,0,0,0,0,0,0,0,0,0,0,0,0,0,13,19,13,13,0,0,0,0,0,0,0,0,0,0,50,0,0,0,0,0,0,0,0,0,13,19,19,19,19,19,19,19,19,19,19,19,19,19
19,19,19,19,19,13,0,0,0,0,0,0,0,0,0,0,0,0,0,0,0,0,0,0,0,0,0,0,0,0,0,0,0,0,0,0,0,0,0,0,13,19,19,19,0,0,0,0,0,0,0,0,0,0,0,0,0,0,0,0,0,0,0,0,13,19,19,19,19,19,19,19,19,19,19,19,19,19
19,19,19,19,19,13,0,0,0,0,0,0,0,0,0,0,0,0,0,0,0,0,0,0,0,0,0,0,0,0,0,0,0,0,0,0,0,0,0,0,13,19,19,19,0,0,0,0,0,12,0,0,20,0,0,0,0,50,0,0,0,0,0,0,13,19,19,19,19,19,19,19,19,19,19,19,19,19
19,19,19,19,19,13,0,0,0,0,0,0,0,0,0,0,0,0,0,0,0,0,0,0,0,0,0,0,0,0,0,0,0,0,0,0,0,0,0,0,13,13,13,13,10,10,10,10,10,13,0,0,0,0,0,0,0,0,0,0,20,0,0,0,13,19,19,19,19,19,19,19,19,19,19,19,19,19
19,19,19,19,19,13,0,0,0,0,0,0,0,0,0,0,0,0,0,0,0,0,0,0,0,0,0,0,0,0,0,0,0,0,0,0,0,0,0,0,13,13,13,13,13,13,13,13,13,13,0,0,0,0,0,0,0,0,0,0,0,0,0,0,13,19,19,19,19,19,19,19,19,19,19,19,19,19
19,19,19,19,19,13,0,0,0,0,0,0,0,0,0,0,0,0,0,0,0,0,0,0,0,0,0,0,0,0,0,0,0,0,0,0,0,0,0,0,1,1,1,1,1,1,1,1,1,1,0,0,0,0,0,0,0,0,20,0,0,0,0,0,13,19,19,19,19,19,19,19,19,19,19,19,19,19
19,19,19,19,19,13,0,0,0,0,0,0,0,0,0,0,0,0,0,0,0,0,0,0,0,0,0,0,0,0,0,0,0,0,0,0,0,0,0,0,1,1,1,1,1,1,1,1,1,1,0,0,0,0,0,0,0,0,0,0,0,0,0,0,13,19,19,19,19,19,19,19,19,19,19,19,19,19
19,19,19,19,19,13,0,0,0,0,0,0,0,0,0,0,0,0,0,0,0,0,0,0,0,0,0,0,0,0,0,0,0,0,0,0,0,0,0,0,1,1,1,1,1,1,1,1,1,1,0,0,0,0,0,0,0,0,0,0,0,0,0,0,13,19,19,19,19,19,19,19,19,19,19,19,19,19
19,19,19,19,19,13,0,0,0,0,0,0,0,0,0,0,0,0,0,0,0,0,0,0,0,0,0,0,0,0,0,0,0,0,0,0,0,0,0,0,1,1,1,1,1,1,1,1,1,1,0,0,0,0,0,0,50,0,0,0,0,0,0,0,13,19,19,19,19,19,19,19,19,19,19,19,19,19
19,19,19,19,19,13,0,0,0,0,0,0,0,0,0,0,0,0,0,0,0,0,0,0,0,0,0,0,0,0,0,0,0,0,50,0,0,0,0,0,1,1,1,1,1,1,1,1,1,1,0,0,0,0,0,50,0,0,0,11,10,10,10,10,13,19,19,19,19,19,19,19,19,19,19,19,19,19
19,19,19,19,19,13,0,0,0,0,0,0,0,0,0,0,0,0,0,0,0,0,0,0,0,0,0,0,0,0,0,0,0,0,0,0,0,0,0,0,1,1,1,1,1,1,1,1,1,1,0,0,20,0,0,0,0,0,0,13,19,19,19,19,19,19,19,19,19,19,19,19,19,19,19,19,19,19
19,19,19,19,19,13,0,0,0,0,0,0,0,0,20,0,0,0,0,0,0,0,0,0,0,0,0,0,0,0,0,0,50,0,0,0,0,0,0,0,1,1,1,1,1,1,1,1,1,1,0,0,0,0,0,0,0,0,0,13,19,19,19,19,19,19,19,19,19,19,19,19,19,19,19,19,19,19
19,19,19,19,19,13,0,0,0,20,0,0,0,0,0,0,0,0,0,0,0,0,0,0,0,0,0,0,0,0,0,0,0,0,0,0,13,0,0,0,1,1,1,1,1,1,1,1,1,1,0,0,0,0,0,20,0,0,0,13,19,19,19,19,19,19,19,19,19,19,19,19,19,19,19,19,19,19
19,19,19,19,19,13,0,0,0,0,0,0,0,0,0,0,0,0,0,0,0,0,0,0,0,0,0,0,0,0,50,0,0,0,0,13,13,13,0,0,1,1,1,1,1,1,1,1,1,1,0,0,0,50,0,0,0,0,0,13,19,19,19,19,19,19,19,19,19,19,19,19,19,19,19,19,19,19
19,19,19,19,19,13,0,0,0,0,0,0,0,0,0,0,0,0,0,0,0,0,0,0,0,0,0,20,0,0,0,0,0,0,0,13,19,13,13,13,1,1,1,1,1,1,1,1,1,1,0,0,0,0,0,0,0,0,0,13,19,19,19,19,19,19,19,19,19,19,19,19,19,19,19,19,19,19
19,19,19,19,19,13,0,50,0,0,0,0,0,0,0,0,11,10,10,10,12,0,0,0,0,0,0,0,0,0,0,0,0,0,0,13,19,19,19,13,1,1,1,1,1,1,1,1,1,1,0,0,0,50,0,0,0,0,13,13,19,19,19,19,19,19,19,19,19,19,19,19,19,19,19,19,19,19
19,19,19,19,19,13,10,12,0,0,0,0,0,0,0,0,13,19,19,19,13,0,0,31,0,0,0,0,0,0,20,0,0,0,0,13,19,19,19,13,1,1,1,1,1,1,1,1,1,1,0,0,0,0,0,0,0,0,13,19,19,19,19,19,19,19,19,19,19,19,19,19,19,19,19,19,19,19
19,19,19,19,19,19,19,13,12,0,0,20,0,0,0,0,13,19,19,19,13,10,10,10,12,0,0,0,0,0,0,0,0,0,13,13,19,19,19,13,13,1,1,1,1,1,1,1,1,1,0,0,0,20,0,0,0,0,13,19,19,19,19,19,19,19,19,19,19,19,19,19,19,19,19,19,19,19
19,19,19,19,19,19,19,19,13,0,0,0,0,0,0,0,13,19,19,19,19,19,19,19,13,0,0,0,12,0,0,0,0,0,13,19,19,19,19,19,13,1,1,1,1,1,1,1,1,1,0,0,0,0,0,0,0,0,13,19,19,19,19,19,19,19,19,19,19,19,19,19,19,19,19,19,19,19
19,19,19,19,19,19,19,19,13,0,0,0,0,0,0,0,13,19,19,19,19,19,19,19,13,10,10,10,13,0,51,0,0,0,13,19,19,19,19,19,13,1,1,1,1,1,1,1,1,1,0,0,0,0,0,0,0,0,13,19,19,19,19,19,19,19,19,19,19,19,19,19,19,19,19,19,19,19
19,19,19,19,19,19,19,19,13,0,0,0,90,0,0,0,13,19,19,19,19,19,19,19,19,19,19,19,13,0,0,0,0,0,13,19,19,19,19,19,13,1,1,1,1,1,1,1,1,91,0,0,0,0,0,0,0,0,13,19,19,19,19,19,19,19,19,19,19,19,19,19,19,19,19,19,19,19
19,19,19,19,19,19,19,19,13,10,10,10,10,10,10,10,13,19,19,19,19,19,19,19,19,19,19,19,13,0,0,0,0,0,13,19,19,19,19,19,13,10,10,10,10,10,10,10,10,10,10,10,10,10,10,10,10,10,13,19,19,19,19,19,19,19,19,19,19,19,19,19,19,19,19,19,19,19
19,19,19,19,19,19,19,19,19,19,19,19,19,19,19,19,19,19,19,19,19,19,19,19,19,19,19,19,13,0,0,0,0,0,13,19,19,19,19,19,19,19,19,19,19,19,19,19,19,19,19,19,19,19,19,19,19,19,19,19,19,19,19,19,19,19,19,19,19,19,19,19,19,19,19,19,19,19
