11,10,10,10,10,12,0,0,0,0,0,0,0,0,0,0,0,0,0,0,0,0,0,0,0,0,0,0,0,0,0,0,0,0,0,0,0,0,0,0,0,0,0,0,0,0,0,0,0,0,0,0,0,0,0,0,0,0,0,0,0,0,0,0,0,0,0,0,0,0,0,0,0,0,0,0,0,0,0,0,0,0,0,0,0,0,0,11,10,10,10,12
19,19,19,19,19,13,0,0,0,0,0,0,0,0,0,0,0,0,0,0,0,0,0,0,0,0,0,0,0,0,0,0,0,0,0,0,0,0,0,0,0,0,0,0,0,0,0,0,0,0,0,0,0,0,0,0,0,0,0,0,0,0,0,0,0,0,0,0,0,0,0,0,0,0,0,0,0,0,0,0,0,0,0,0,0,0,0,13,19,19,19,19
19,19,19,19,19,13,0,0,0,0,0,0,0,0,0,0,0,0,0,0,0,0,0,0,0,0,0,0,0,0,0,0,0,0,0,0,0,0,0,0,0,0,0,0,0,0,0,0,0,0,0,0,0,0,0,0,0,0,0,0,0,0,0,0,0,0,0,0,0,0,0,0,0,0,0,0,0,0,0,0,0,0,0,0,0,0,0,13,19,19,19,19
19,19,19,19,19,13,0,0,0,0,0,0,0,0,0,0,0,0,0,0,0,0,0,0,0,0,0,0,0,0,0,0,0,0,0,0,0,0,0,0,0,0,0,0,0,0,0,0,0,0,0,0,0,0,0,0,0,0,0,0,0,0,0,0,0,0,0,0,0,0,0,0,0,0,0,0,0,0,0,0,0,0,0,0,0,0,0,13,19,19,19,19
19,19,19,19,19,13,0,0,0,0,0,0,0,0,0,0,0,0,0,0,0,0,0,0,0,0,0,0,0,0,0,0,0,0,0,0,0,0,0,0,0,0,0,0,0,0,0,0,0,0,0,0,0,0,0,0,0,0,0,0,0,0,0,0,0,0,0,0,0,0,0,0,0,0,0,0,0,0,0,0,0,0,0,0,0,0,0,13,19,19,19,19
19,19,19,19,19,13,0,0,0,0,0,0,0,0,0,0,0,0,0,0,0,0,0,0,0,0,0,0,0,0,0,0,0,0,0,0,0,0,0,0,0,0,0,0,0,0,0,0,0,0,0,0,0,0,0,0,0,0,0,0,0,0,0,0,0,0,0,0,0,0,0,0,0,0,0,0,0,0,0,0,0,0,0,0,0,0,0,13,19,19,19,19
19,19,19,19,19,13,0,0,0,0,0,0,0,0,0,0,0,0,0,0,0,0,0,0,0,0,0,0,0,0,0,0,0,0,0,0,0,0,0,0,0,0,0,0,0,0,0,0,0,0,0,0,0,0,0,0,0,0,0,0,0,0,0,0,0,0,0,0,0,0,0,0,0,0,0,0,0,0,0,0,0,0,0,0,0,0,0,13,19,19,19,19
19,19,19,19,19,13,0,0,0,0,0,0,0,0,0,0,0,0,0,0,0,0,0,0,0,0,0,0,0,0,0,0,0,0,0,0,0,0,0,0,0,0,0,0,0,0,0,0,0,0,0,0,0,0,0,0,0,0,0,0,0,0,0,0,0,0,0,0,0,0,0,0,0,0,0,0,0,0,0,0,0,50,0,0,0,0,11,13,19,19,19,19
19,19,19,19,19,13,0,0,0,0,0,0,0,0,0,0,0,0,0,0,0,0,0,0,0,0,0,0,0,0,0,0,0,0,0,0,0,0,0,0,0,0,0,0,0,0,0,0,0,0,0,0,0,0,0,0,0,0,0,0,0,0,0,0,0,0,0,0,0,0,0,0,0,0,0,0,0,0,0,0,0,0,0,0,0,0,13,19,19,19,19,19
19,19,19,19,19,13,0,0,0,0,0,0,0,0,0,0,0,0,0,0,0,0,0,0,0,0,0,0,0,0,0,0,0,0,0,0,0,0,0,0,0,0,0,0,0,0,0,0,0,0,0,0,0,0,0,0,0,0,0,0,0,0,0,0,0,0,0,0,0,0,0,0,0,0,0,0,0,0,0,0,0,50,0,0,0,0,13,19,19,19,19,19
19,19,19,19,19,13,0,0,0,0,0,0,0,0,0,0,0,0,0,0,0,0,0,0,0,0,0,0,0,0,0,0,0,0,0,0,0,0,0,0,0,0,0,0,0,0,0,0,0,0,0,0,0,0,0,0,0,0,0,0,0,0,0,0,0,0,0,0,0,0,0,0,0,0,0,0,0,10,0,0,0,0,0,0,0,0,13,19,19,19,19,19
19,19,19,19,19,13,0,0,0,0,0,0,0,0,0,0,0,0,0,0,0,0,0,0,0,0,0,0,0,0,0,0,0,0,0,0,0,0,0,0,0,0,0,0,0,0,0,0,0,0,0,0,0,0,0,0,0,0,0,0,0,0,0,0,0,0,0,0,0,0,0,0,0,0,0,0,0,13,0,0,0,50,0,0,0,0,13,19,19,19,19,19
19,19,19,19,19,13,0,0,0,0,0,0,0,0,0,0,0,0,0,0,51,0,0,0,0,0,0,0,0,0,0,0,0,0,0,0,0,0,0,0,0,0,0,0,0,0,0,0,0,0,0,0,0,0,0,0,0,0,0,0,0,0,0,0,0,0,0,0,0,0,0,0,0,0,0,0,0,13,0,0,0,20,0,0,0,0,13,19,19,19,19,19
19,19,19,19,19,13,0,0,0,0,0,0,0,0,0,0,0,0,0,0,0,0,0,0,0,0,0,0,0,0,0,0,0,0,0,0,0,0,0,0,0,0,0,0,0,0,0,0,0,0,0,0,0,0,0,0,0,0,0,0,0,0,0,0,0,0,0,0,0,0,0,0,0,0,0,0,0,13,0,0,0,0,0,0,92,0,13,19,19,19,19,19
19,19,19,19,19,13,0,0,0,0,0,0,0,0,0,0,0,0,0,0,0,0,0,0,0,0,0,0,0,0,0,0,0,0,0,0,0,0,0,0,0,0,0,0,0,0,0,0,0,0,0,0,0,0,0,0,0,0,0,0,0,0,0,0,0,0,0,0,0,0,0,0,0,0,0,0,0,13,10,12,0,41,0,11,10,12,13,19,19,19,19,19
19,19,19,19,19,13,0,0,0,0,0,0,0,0,0,0,0,0,0,0,0,0,0,0,0,0,0,0,0,0,0,0,0,0,0,0,0,0,0,0,0,0,0,0,0,0,0,0,0,0,0,0,0,0,0,0,0,0,0,0,0,0,0,0,50,0,51,0,0,0,0,0,0,0,0,0,0,13,19,13,0,0,0,13,19,19,19,19,19,19,19,19
19,19,19,19,19,13,0,0,0,0,0,0,0,0,0,0,0,0,0,0,20,0,0,0,0,0,0,0,0,0,0,50,0,20,0,50,0,0,0,0,0,0,0,0,0,0,0,0,0,0,0,0,0,0,0,0,0,0,0,0,50,0,50,11,10,10,10,10,12,0,0,0,0,0,0,0,0,13,19,13,0,41,0,13,19,19,19,19,19,19,19,19
19,19,19,19,19,13,0,0,0,0,0,0,0,0,0,0,0,0,0,0,0,0,0,0,0,0,0,0,0,0,0,0,0,0,0,0,0,0,0,0,0,0,0,0,0,0,0,0,0,0,0,0,0,0,0,0,11,10,10,10,10,10,10,19,19,19,19,19,13,0,0,0,0,0,0,0,0,13,19,13,0,0,0,13,19,19,19,19,19,19,19,19
19,19,19,19,19,13,0,0,0,0,0,0,0,0,0,0,0,0,0,0,41,0,0,0,0,0,0,0,20,0,0,0,0,0,0,0,0,0,20,0,0,0,0,0,0,0,0,0,0,0,0,0,0,0,0,0,0,0,13,13,13,13,13,13,13,13,13,13,13,0,0,0,0,0,0,0,0,13,13,13,0,41,0,13,13,13,19,19,19,19,19,19
19,19,19,19,19,13,0,0,0,0,0,0,0,0,0,0,0,0,0,0,0,0,0,0,0,0,0,0,0,0,0,0,0,0,0,0,0,0,0,0,0,0,0,0,0,0,0,0,0,0,0,0,0,0,0,0,0,0,1,1,1,1,1,1,1,0,0,0,0,0,0,0,0,0,0,20,0,0,1,1,20,0,20,1,1,13,19,19,19,19,19,19
19,19,19,19,19,13,0,0,0,0,0,0,0,0,0,0,0,0,0,0,50,0,0,10,10,10,12,0,0,0,0,11,10,10,10,12,0,0,0,0,0,10,10,12,0,0,0,0,50,0,0,0,0,0,0,0,0,0,1,1,1,1,1,1,1,0,0,0,0,0,0,0,0,0,0,0,0,0,1,1,0,0,0,1,1,13,19,19,19,19,19,19
19,19,19,19,19,13,0,0,0,0,0,0,0,0,0,0,0,0,0,0,0,0,0,13,19,19,13,0,0,0,0,13,19,19,19,13,0,0,0,0,0,13,19,13,0,0,20,0,0,0,0,0,0,0,0,0,0,0,1,1,1,1,1,1,1,0,0,0,0,0,0,0,0,0,0,0,0,0,50,1,0,0,0,1,50,13,19,19,19,19,19,19
19,19,19,19,19,13,0,0,0,0,0,0,0,0,0,0,0,0,0,0,20,0,0,13,19,19,19,13,13,13,13,19,19,19,19,19,13,13,13,13,13,19,19,13,0,0,0,0,20,0,0,10,10,12,0,0,0,0,1,1,1,1,1,1,1,0,20,0,0,0,0,0,0,0,0,0,0,0,11,12,0,0,0,11,10,13,19,19,19,19,19,19
19,19,19,19,19,13,0,20,0,20,0,0,0,0,20,0,50,0,0,0,0,0,0,13,19,19,19,19,19,19,19,19,19,19,19,19,19,19,19,19,19,19,19,13,0,0,0,0,0,0,0,0,0,0,0,0,20,0,1,1,1,1,1,1,1,0,0,0,0,0,0,0,91,0,0,0,0,0,13,13,20,0,20,13,13,13,19,19,19,19,19,19
19,19,19,19,19,13,0,0,0,0,0,0,0,0,0,0,0,0,0,0,0,0,0,13,19,19,19,19,19,19,19,19,19,19,19,19,19,19,19,19,19,19,19,13,0,0,0,0,0,0,0,0,0,0,0,0,0,0,1,1,1,1,1,1,1,0,0,0,0,0,11,10,10,10,12,0,0,0,1,1,0,0,0,1,1,13,19,19,19,19,19,19
19,19,19,19,19,13,0,0,0,0,0,0,0,0,0,0,0,0,0,0,0,0,0,13,19,19,19,19,19,19,19,19,19,19,19,19,19,19,19,19,19,19,19,13,0,0,0,0,0,0,0,0,0,0,0,0,0,0,1,11,10,10,10,10,12,0,0,0,0,0,13,19,19,19,13,12,0,0,1,1,0,0,0,1,1,13,19,19,19,19,19,19
19,19,19,19,19,13,0,0,90,0,0,0,0,0,0,11,10,10,10,10,10,10,10,13,19,19,19,19,19,19,19,19,19,19,19,19,19,19,19,19,19,19,19,13,0,0,0,0,0,11,10,10,10,10,12,0,0,0,1,13,19,19,19,19,13,0,0,31,0,0,13,19,19,19,19,13,12,0,1,1,0,0,0,51,1,13,19,19,19,19,19,19
19,19,19,19,19,13,10,10,10,10,10,10,10,10,10,13,19,19,19,19,19,19,19,19,19,19,19,19,19,19,19,19,19,19,19,19,19,19,19,19,19,19,19,13,10,10,10,10,10,13,19,19,19,19,13,10,10,10,10,19,19,19,19,19,19,10,10,10,10,10,13,19,19,19,19,19,13,13,13,13,0,0,0,13,13,13,19,19,19,19,19,19
19,19,19,19,19,19,19,19,19,19,19,19,19,19,19,19,19,19,19,19,19,19,19,19,19,19,19,19,19,19,19,19,19,19,19,19,19,19,19,19,19,19,19,19,19,19,19,19,19,19,19,19,19,19,19,19,19,19,19,19,19,19,19,19,19,19,19,19,19,19,19,19,19,19,19,19,19,19,19,13,0,0,0,13,19,19,19,19,19,19,19,19
